WE ./txtr/west.png
SO ./txtr/south.png
NO ./txtr/north.png
EA ./txtr/east.png

F 17,18,255
C 9,86,99

111111
100101
101001
1100N1
111111
