NO ./path_to_the_north_texture
SO ./path_to_the_south_texture
WE ./path_to_the_west_texture
EA ./path_to_the_east_texture

F 220,100,0
C 225,30,0

11111111111111
10000010000011
11110000001111
110000S0000001
11110000001111
11000000000001
10000000000001
10101001010101
10000000000001
10101001010101
10000000000001
11000011000011
11000011000011
11111111000011
11111111111111
