NO ./txtr/north.png
SO ./txtr/south.png
WE ./txtr/west.png
EA ./txtr/east.png

F 97, 72, 43
C 99,99,99

11111111111111
10000010000011
11140000001111
110000S0000001
11110000001111
11000020000001
10000000000001
10101001010101
10000000000001
10101001010101
10000000000001
11000011000011
11000011000011
11111111000011
11111111111111
